2-Aminoadipicacid	Aad
2-Aminobutyricacid	Aba
Anticapsin	Aca
2-Aminoisobutyricacid	Aiba
allo-Isoleucine	aIle
Alanine	Ala
alpha-methylcysteine	amCys
alpha-amino-phenyl-valericacid	aApv
Arginine	Arg
Asparagine	Asn
AsparticAcid	Asp
allo-Threonine	aThr
capreomycidine	Cap
Citrulline	Cit
coronamicacid	Cor
2-carboxyquinoxaline	cQui
cycloOrnithine	cOrn
Cysteine	Cys
cysteicacid	Cya
D-2-Aminoadipicacid	D-Aad
D-2-Aminobutyricacid	D-Aba
D-allo-Isoleucine	D-aIle
D-Alanine	D-Ala
D-alpha-methylcysteine	D-amCys
D-alpha-amino-phenyl-valericacid	D-Aapv
D-Arginine	D-Arg
D-Asparagine	D-Asn
D-AsparticAcid	D-Asp
D-allo-Threonine	D-aThr
D-Citrulline	D-Cit
D-cycloOrnithine	D-cOrn
D-Cysteine	D-Cys
D-cysteicacid	C-Cya
D-2,4-diaminobutyricacid	D-Dab
(2R,3R)-2,3-diaminobutyricacid	D-3Dab
D-3,5-dihydroxyphenylglycine	dohPhg
D-2,3-Diaminopropionicacid	D-Dap
D-enduracididine	D-end
D-alpha-ethylnorvaline	D-aEnv
D-Glutamine	D-Gln
D-GlutamicAcid	D-Glu
D-HydroxyPhenylGlycine	D-ohPhg
D-Pipecolicacid	D-Pip
D-Homoserine	D-hSer
D-homoserinelactone	D-hSel
D-Homotyrosine	D-hTyr
D-Isoleucine	D-Ile
D-isovaline	D-Iva
D-kynurenine	D-Kyn
D-Leucine	D-Leu
D-Lysine	D-Lys
D-methyl-2-aminooctanoicacid	D-mAoa
D-Ornithine	D-Orn
D-PhenylGlycine	D-Phg
D-Phenylalanine	D-Phe
D-Proline	D-Pro
D-phosphinothricin	D-Ppt
D-Serine	D-Ser
D-tert-Leucine	D-tLeu
D-Threonine	D-Thr
D-Tryptophan	D-Trp
D-Tyrosine	D-Tyr
D-Valine	D-Val
2,4-diaminobutyricacid	Dab
(2S)-2,3-diaminobutyricacid	3Dab
dehydroalanine	dhAla
2,3-Dehydro-Tryptophan	dhTrp
dehydro-cysteine	dhCys
3,5-dihydroxyphenylglycine	dohPhg
D-dihydroxyphenylthiazolgroup	D-Def
dihydroxyphenylthiazolgroup	Def
2,3-Diaminopropionicacid	Dap
enduracididine	End
alpha-ethylnorvaline	aEnv
Glutamine	Gln
GlutamicAcid	Glu
Glycine	Gly
homoarginine	hArg
homoisoleucine	hIle
Histidine	His
D-Histidine	D-His
hydroxypicolinicacid	ohPa
HydroxyPhenylGlycine	ohPhg
Homophenylalanine	hPhe
Homoserine	hSer
homoserinelactone	hSel
Homotyrosine	hTyr
Isoleucine	Ile
isovaline	Iva
kynurenine	Kyn
(2S,3S)-2,3-diaminobutyricacid	3Dab
Leucine	Leu
Lysine	Lys
methyl-2-aminooctanoicacid	mAoa
Methionine	Met
D-Methionine	D-Met
norcoronamicacid	nCar
Norvaline	nVal
Ornithine	Orn
phenylglycine	Phg
Phenylalanine	Phe
Proline	Pro
phosphinothricin	Ppt
R-coronamicacid	D-Cor
R-norcoronamicacid	D-nCar
Serine	Ser
tert-Leu	tLeu
Threonine	Thr
Tryptophan	Trp
Tyrosine	Tyr
Valine	Val
Dehydrobutyrine	dhBut
Quinoline-2-carboxylicacid	Qui
beta-Alanine	bAla
2,3-dihydroxybenzoicacid	dohBza
beta-lysine	bLys
(2S,3R)-2-amino-3-hydroxy-4-(4-nitrophenyl)butanoate	Nit
D-2-hydroxyisovalerate	D-ohIva
2-hydroxyisovalerate	ohIva
2,3-diamino-3-methyl-propanoicacid	dnMpa
4,5-Dihydroxyornithine	dohOrn
4,5-Dihydroxyhomotyrosine	diohhTyr
3-Hydroxyglutamine	ohGln
4-butenyl-4-methylthreonine	bumThr
3-aminopropanimidamide	aPaa
valinol	Valol
4-Hydroxyvaline	ohVal
4-Hydroxyindole-3-carboxylicacid	ohInc
salicylicacid	Sal
2-Methylserine	mSer
Alaninol	Alaol
4,5-dehydroarginine	dhArg
3-(3-Pyridyl)-Alanine	pAla
3-methyltyrosine	mTyr
Glycolicacid	Gla
D-lysergicacid	D-Lya
N-acetylphenylalanine	aPhe
phenylaceticacid	Phaa
alpha-ketoisovalericacid	aKia
alpha-ketoisocaproicacid	aKic
hydrocinnamicacid	hCin
3-hydroxy-4-O-methyl-5-methyltyrosine	ohmmTyr
4-methylproline	mPro
Isoleucine	Ile
3-[(1R,2R)-2-Nitrocyclopropyl]-L-alanine	nAla
dehydrobutyrine	dhBut
(R)beta-tyrosine	bTyr
Pipecolicacid	Pip
2-Amino-9,10-epoxy-8-oxodecanoidacid	aeOda
L-piperazicacid	Piz
dehydrotyrosine	dhTyr
Beta-hydroxycyclohex-2-enylalanine	bohCea
alpha-ketoisovalericacid	aKia
2-methyl-beta-alanine	mbAla
Glycocyamine	Glc
nrp	*
4-methylglutamicacid	mGlu
malonylcoa	Mal
methylmalonylcoa	mMal
ethylmalonylcoa	eMal
methoxymalonylcoa	mxMal
wildcard	*